........G
.........
.........
OOOOOOOO.
.........
...A.....