........G
.........
.........
.OOOOOOOO
.........
...A.....