........G
.........
.........
.OOOOOOO.
.........
...A.....